1110111
1000001
1011101
1010101
1010111
1000001
1110111




